Sci1	มนุษย์อวกาศที่เหยียบดวงจันทร์เป็นคนแรกชื่ออะไร	นีล เอ อาร์มสตรอง	นีล,เอ,อาร์มสตรอง|นีล,อาร์มสตรอง|Niels Armstrong
Sci2	ยานอวกาศที่พามนุษย์ไปเหยียบดวงจันทร์สำเร็จเป็นครั้งแรกชื่ออะไร	อพอลโล สิบเอ็ด	อพอลโล,สิบเอ็ด|อพอลโล,11
Sci3	ปัจจุบัน ระบบสุริยจักรวาลมีดาวเคราะห์กี่ดวง	แปด	แปด
Sci4	อดีตดาวเคราะห์ที่ถูกปลดออกจากระบบสุริยจักรวาลชื่ออะไร	พลูโต	พลูโต
Sci5	นักวิทยาศาสตร์ที่ค้นพบแรงโน้มถ่วงคือใคร	เซอร์ ไอแซ็ก นิวตั้น	นิวตั้น|newton
Sci6	นักวิทยาศาสตร์ที่คิดค้นทฤษฎีสัมพันธภาพคือใคร	อัลเบิร์ต ไอน์สไตน์	ไอน์สไตน์
Sci7	นักวิทยาศาสตร์ที่ได้รับรางวัลโนเบลในสาขาวิทยาศาสตร์สองครั้งคือใคร	มารี คูรี	มารี,คูรี
Sci8	ไข้หวัดใหญ่เกิดจากเชื้อโรคชนิดใด	ไวรัส	ไวรัส|เชื้อไวรัส|virus
Sci9	ยาเพนนิซิลินฆ่าเชื้อโรคชนิดใด	แบคทีเรีย	แบคทีเรีย
Sci10	สัตว์ใดเป็นพาหะไข้เลือดออก	ยุงลาย	ยุงลาย
Sci11	สัตว์ใดเป็นพาหะไข้มาลาเรียหรือไข้ป่า	ยุงก้นปล่อง	ยุงก้นปล่อง
Sci12	มนุษย์มีโครโมโซมกี่คู่	ยี่สิบสาม	ยี่สิบสาม|ยีบ,สาม
Sci13	สัตว์ที่มีพันธุกรรมใกล้เคียงมนุษย์มากที่สุดคืออะไร	ลิงชิมแปนซี และลิงโบโนโบ	ชิมแปนซี|ชิ้มป์|Chimpanzee|Bonobo|โบโนโบ
Sci14	สัตว์ที่เกิดจากการทดลองโคลนนิ่งชนิดแรกคืออะไร	แกะ ชื่อดอลลี่	แกะ
Sci15	กัลปังหาเป็นพืชหรือสัตว์	สัตว์	สัตว์
Sci16	สัตว์เลี้ยงลูกด้วยนมที่ใหญ่ที่สุดในโลกคืออะไร	ปลาวาฬสีน้ำเงิน	ปลาวาฬสีน้ำเงิน|ปลาวาฬ|วาฬ|วาฬสีน้ำเงิน|blue whale
Sci17	โปรแกรมหมากล้อมที่สามารถโค่นแชมป์โลกได้ชื่อว่าอะไร	อัลฟ่าโก	อัลฟา|อัลฟ่า
Sci18	สารเคมีที่ให้รสเผ็ดในพริกมีชื่อว่าอะไร	แคป เซ ซิน	capsaicin|เซ,ซิน|ไซ,ซิน
Sci19	โลหะชนิดเดียวที่เป็นของเหลวที่อุณหภูมิห้องคืออะไร	ปรอท	ปรอท|mercury
Sci20	ธาตุอะไรมีน้ำหนักน้อยที่สุด	ไฮโดรเจน	ไฮโดรเจน|hydrogen
Sci21	กาแลคซี่ที่อยู่ใกล้กาแลคซี่ทางช้างเผือกที่สุดมีชื่อว่าอะไร	แอนโดรเมดา	แอนโดรเมดา|andromeda|แอนโดรเมด้า
Sci22	ปีแสงเป็นหน่วยวัดอะไร	ระยะทาง 1 ปีแสงเท่ากับระยะทางที่แสงเดินทางได้ใน 1 ปี	ระยะ,ทาง|ความ,ยาว
Sci23	ชั้นบรรยากาศของโลกชั้นล่างสุดมีชื่อว่าอะไร	โทรโพสเฟียร์	โทรโพสเฟียร์|โทรโพสเฟียร์ส
Sci24	อากาศมีก๊าซอะไรมากที่สุด	ไนโตรเจน	ไนโตรเจน
Sci25	ดวงอาทิตย์ประกอบไปด้วยธาตุชนิดไหนมากที่สุด	75 percent ของดวงอาทิตย์ประกอบไปด้วย ไฮโดรเจน	ไฮโดรเจน
Sci26	น้ำย่อยในกระเพาะอาหารประกอบไปด้วยกรดชนิดใด	กรดไฮโดรคลอริก หรือ กรดเกลือ	กรด,เกลือ|ไฮโดรคลอริก
Sci27	ใครเป็นผู้คิดค้นโทรศัพท์	อเล็กซานเดอร์ เกรแฮม เบล	อเล็กซานเดอร์,เกรแฮม,เบล
Sci28	ใครเป็นผู้คิดค้นหลอดไฟ	โทมัส เอดิสัน	เอดิสัน
Sci29	วิตามินอะไรที่ร่างกายผลิดได้เมื่อโดนแสงอาทิตย์	วิตามินดี	ดี
Sci30	อวัยวะภายในที่มีน้ำหนักมากที่สุดของมนุษย์คืออะไร	ตับ	ตับ
